title	content
This new slow-burn thriller features one of 2024’s best performances	Conclave doesn’t just feel like an Agatha Christie mystery — it also begins like one. The film’s opening moments follow its beleaguered protagonist, Thomas Cardinal Lawrence (Ralph Fiennes), as he hu… [+5863 chars]
Santa Barbara Film Festival Awards: Ralph Fiennes Set As Performer Of The Year For ‘Conclave’	Ralph Fiennes, who currently stars in Focus Features’ awards-season drama Conclavefrom Edward Berger, has been selected to receive the Outstanding Performer of the Year Award at the 40th Santa Barbar… [+1187 chars]
‘Conclave’ Screenwriter Peter Straughan on That Wild Ending, and Why ‘The Goldfinch’ Movie Was ‘a Mistake from the Beginning’	Editor’s Note: The following story contains major spoilers for the movie “Conclave,” now in theaters.  British screenwriter and playwright Peter Straughan is likely looking at a Best Adapted Screenpl… [+9873 chars]
It’s Time for Ralph Fiennes’ Third Oscar Nomination: The Actor on ‘Conclave,’ Playing Odysseus, and Danny Boyle’s ’28 Years Later’	Can a great actor be taken for granted?   It’s been 30 years since Ralph Fiennes broke out as vicious Nazi Amon Goeth in “Schindler’s List,” which earned him his first Oscar nomination, followed thre… [+8539 chars]
Older Demos, Still Elusive, Bless ‘Conclave’ Amid Indie Surge – Specialty Box Office	Four top films this weekend are indies – five including The Substance at no. 11, as the specialty market roars back to life. No. 3 at the domestic box office is a great story, Conclave from Focus Fea… [+4730 chars]
Acclaimed Pope Thriller ‘Conclave’ Gets Digital Streaming Date	"Ralph Fiennes in ""Conclave.""  Focus Features  Conclavethe critically acclaimed papal thriller starring Ralph Fiennesis coming soon to digital streaming.  Rated PG, Conclave opened in theaters on Octo… [+2626 chars]"
‘Small Things Like These’, ‘Christmas Eve In Miller’s Point’, ‘Bird’, ‘Meanwhile On Earth’ New, ‘Anora’ Goes Wide – Specialty Preview	Box office darling Anora, Sean Baker’s Cannes Palme d’Or winner from Neon, goes wide Friday after a slow platform, expanding to 1,104 screens as indies continue to bust onto screens. Searchlight Pict… [+4439 chars]
Peter Bart: Indies Put Their Faith In Older Demos For Serious Fare Like ‘Conclave’	“The best antidote for a bad election is a good movie,” Richard M. Nixon once proclaimed, and for many filmgoers this week Conclavehelped blot out the political noise. A papal thriller with a shock e… [+2773 chars]
Jesse Eisenberg, Kieran Culkin Drive ‘A Real Pain’ To Top 3 Limited Opening As Audiences Dig Diverse Indie Slate – Specialty Box Office	The independent film fall festival love affair with moviegoers continues with A Real Pain posting the year’s third best per screen average. Anora continues its standout run as does Conclave. The Ralp… [+3489 chars]
Edward Berger & Austin Butler Out With Hot Time Travel Package ‘The Barrier’; MacMillan Hedges To Adapt His Own Short Story – The Dish	EXCLUSIVE: All Quiet helmer Edward Berger and Austin Butler are out to the town with The Barrier, a hot time travel package that is expected to spur competitive bidding, sources tell Deadline.  Plot … [+2084 chars]
Conclave Review: The Picking of a Pope Becomes Fascinating Viewing — Seriously	Conclave begins with a death, but while the Ralph Fiennes-starring movie isn’t a murder mystery, director Edward Berger’s follow-up to 2022’s All Quiet on the Western Front almost treats it that way.… [+5132 chars]
‘Venom: The Last Dance’ Foxtrots To $8M In Thursday Previews – Box Office	EXCLUSIVE: Currently we hear that Sony/Marvel’s Venom: The Last Danceis eyeing around $8M in previews tonight, maybe more by the morning. Showtimes began at 2PM in U.S. Canada at 3,500 locations.   A… [+1864 chars]
There can only be one pope in the delightfully preposterous 'Conclave'	Ralph Fiennes in Conclave.  Focus Features  The new movie Conclave is a fun and twisty political thriller. Ralph Fiennes plays a cardinal tasked to managing the secretive process in which the pope is… [+425 chars]
Conclave Ending Explained: Breaking Down The Shocking Twist And What Director Edward Berger Has To Say About It	Spoiler Warning! The following article contains major spoilers for the Conclave ending. If you have yet to see Edward Berger’s papal thriller and don’t want the masterful twist ruined, please come ba… [+6464 chars]
‘Venom 3’ slinks to $51 million, lowest opening weekend of comic book trilogy	Venom: The Last Dance is No. 1 at the box office, but the comic book film fell significantly short of expectations.  The third and final entry in Sonys Marvel antihero series, led by Tom Hardy, opene… [+5728 chars]
Box Office: ‘Venom: The Last Dance’ Misses Projections by Millions as Superhero Films Popularity Continues to Crater	NEW YORK (AP) Venom: The Last Dance showed less bite than expected at the box office, collecting $51 million in its opening weekend, according to studio estimates Sunday, significantly down from the … [+2612 chars]
Post-Screening Movie Hype Tweets, Decoded	A new Oscar combatant has stepped into the Colosseum. Over the past week, Paramount unveiled Ridley Scotts Gladiator II to a handpicked audience of journalists and influencers, many of whom duly part… [+7717 chars]
‘Venom: The Last Dance’ Off to $8.5 Million Start at Thursday Box Office	Sony/Columbias Venom: The Last Dance is off to a decent start in Thursday previews at the box office, earning $8.5 million from 3,452 locations.   That is down from the $11.4 million preview total ea… [+784 chars]
How Every Oscar Movie Can Be the Anti-Trump Movie	When did you realize your brain had been permanently broken by the election? My moment came last weekend, when I saw Robert Eggerss Nosferatu and couldnt stop thinking of it as the story of local bus… [+6309 chars]
‘Conclave’: John Lithgow Talks About His Catholic Thriller, ‘The Old Man’ & More [The Discourse Podcast]	In this weeks episode of The Discourse, host Mike DeAngelo has a crisis of faith while discussing Focus Features‘ Conclave. The film follows a Cardinal tasked with leading one of the worlds most secr… [+7494 chars]
'Venom: The Last Dance' misses projections as superhero films' grip on theaters loosens	"New York  ""Venom: The Last Dance"" showed less bite than expected at the box office, collecting $51 million in its opening weekend, according to studio estimates Sunday, significantly down from the al… [+3142 chars]"
Governors Awards Present Honorary Oscars To Juliet Taylor, Quincy Jones, Richard Curtis & Bond Producers In Emotional Kickoff To A Long Season	If you had any doubt that the awards season was in full swing, Sunday night’s 15th Annual Governors Awards ceremony answered it.   If you are, or in any way think you might have a shot at an Oscar no… [+10268 chars]
Box office bite: ‘Venom: The Last Dance’ takes ticket title; ‘Conclave’ shows strong	NEW YORK — “Venom: The Last Dance” showed less bite than expected at the box office, collecting $51 million in its opening weekend, according to studio estimates Sunday, significantly down from the a… [+2651 chars]
'Venom: The Last Dance' misses projections as superhero films' grip on theaters loosens	Venom: The Last Dance showed less bite than expected at the box office, collecting $51 million in its opening weekend, according to studio estimates Sunday, significantly down from the alien symbiote… [+2753 chars]
Just How Glicked Will the 2025 Oscars Get?	Whether you call it Glicked or Wickiator (or even Justin Changs preferred Wadiator, which sounds to me like a lot of hot air), this weekends simultaneous arrival of Gladiator II and Wicked feels like… [+6834 chars]
Awards Season Is Already in Full Swing — A Starry, Teary Academy Governors Awards Is Just the Start	The 15th annual Academy Governors Awards on Sunday night brought tears and laughs to the Ray Dolby Ballroom in Hollywood, as usual packed with Oscar hopefuls and AMPAS voters as the awards season get… [+11279 chars]
'Venom: The Last Dance' misses projections as superhero films' grip on theaters loosens	NEW YORK -- NEW YORK (AP) Venom: The Last Dance showed less bite than expected at the box office, collecting $51 million in its opening weekend, according to studio estimates Sunday, significantly do… [+2624 chars]
[Removed]	[Removed]
The pope has a major secret in 'Conclave.' The stars explain what it is — and what it means	Warning: This article contains spoilers for Conclave.  Conclave begins at a gathering to select a new pope in the name of God though it becomes clear that selecting the next leader of the Roman Catho… [+8505 chars]
‘Venom: The Last Dance’ takes top spot in weekend box office — but falls short of projections	NEW YORK  Venom: The Last Dance showed less bite than expected at the box office, collecting $51 million in its opening weekend, according to studio estimates Sunday, significantly down from the alie… [+3427 chars]
Papal potboiler Conclave lets Ralph Fiennes Cook	Conclave (2024 | UK/USA | 120 minutes | Edward Berger)  The Holy Throne of Saint Peter is vacant. Edward Berger churns a satisfying political potboiler in the Vatican as the titular conclave of Cardi… [+3337 chars]
[Removed]	[Removed]
Venom: The Last Dance misses projections as superhero films' grip on theatres loosens	Venom: The Last Dance showed less bite than expected at the North American box office, collecting US$51 million (S$69 million) in its opening weekend, according to studio estimates Sunday (Oct 27), s… [+2678 chars]
'Conclave' director says controversial scenes in movie about papal elections 'not a takedown of the church'	"EXCLUSIVE - ""Conclave"" director Edward Berger's new movie about the secretive papal election process could bring surprises and shocks to traditional Catholics.  Starring a powerhouse cast, including … [+7974 chars]"
‘Conclave’: How the Striking Umbrellas Shot Was Designed to Convey a Sense of Relentless ‘Forward Movement’	The Vatican-set mystery Conclave opened in theaters today, but one single shot has been the talk of moviegoers all season on the film festival circuit. Late in the film, we see dozens of Catholic car… [+3466 chars]
International Insider: A Trip To MIP; El Gouna Underway; Edward Berger On ‘Conclave’	Hello Insiders, the big international chatter this week came from Cannes, but there’s been plenty of film and TV stories elsewhere. Jesse Whittock here guiding you through. Sign up here.  Another MIP… [+12416 chars]
‘Conclave’ Prays for Oscar Attention: How Do Religious Movies Perform With Academy Voters?	Will the Oscars answer “Conclave’s” prayers?  Edward Berger’s mystery thriller has been one of the buzziest films to emerge from the fall festivals. Adapted from Robert Harris’ 2016 novel, the film p… [+7211 chars]
'Venom: The Last Dance' misses projections as superhero films' grip on theaters loosens	NEW YORKVenom: The Last Dance showed less bite than expected at the box office, collecting $51 million in its opening weekend, according to studio estimates Sunday, significantly down from the alien … [+2759 chars]
From ‘Gangs of New York’ to ‘Conclave,’ Producer Michael Jackman on the ‘100 Different Things’ That Make or Break a Movie’s Success	Producer Michael Jackman has done it all.  He has 35 years of experience in all aspects of motion pictures. Most recently hes produced Conclave, a papal thriller starring Ralph Fiennes that looks to … [+10575 chars]
‘Venom 3’ Slinks to $51 Million, Lowest Opening Weekend of Comic Book Trilogy	“Venom: The Last Dance” is No. 1 at the box office, but the comic book film fell significantly short of expectations.  The third and final entry in Sony’s Marvel antihero series, led by Tom Hardy, op… [+5266 chars]
Ojai Playhouse Reopens as State-of-the-Art Coastal Showcase for Oscar Contenders, Revival Films and Live Shows, After 10-Year Closure	The city of Ojai has a long-established reputation as one of California’s most quintessentially laid-back small towns. But residents and frequent visitors who have a love for movies may actually have… [+12281 chars]
Box Office: ‘Venom: The Last Dance’ Laps Up $22 Million Opening Day — Down From Previous Entries	“Venom: The Last Dance” is two-stepping slower than its series predecessors in North America, after chowing down on $22 million from 4,131 domestic theaters across Friday and previews. That’s well be… [+4073 chars]
Golden Globes 2025: First Predictions With Movie Musicals, A-List Stars and Hit TV Shows Vying for Recognition	Variety Awards Circuit section is the home for all awards news and related content throughout the year, featuring the following: the official predictions for the upcoming Oscars, Emmys, Grammys and T… [+27281 chars]
