title	content
Robert Zemeckis Just Wants to Move You	Robert Zemeckis Here is the most unfashionable movie of 2024which is exactly whats beautiful about it. In a world where even those who profess to love movies largely stream them at home, Here is a pi… [+10438 chars]
Venom 3 set to win weekend box office, but there’s a battle for second spot	Venom: The Last Dance is set to win the North American box office for the second weekend in a row, according to a forecast by Boxoffice Pro.  Sony Pictures’ sci-fi action movie is projected to earn b… [+2036 chars]
‘Here’ Review: Robert Zemeckis Rues Time Lost, Gained, and Wasted with a De-Aged Tom Hanks and Robin Wright	Life isn’t too short — it’s long, as Robert Zemeckis’ brisk, inventive, and earnest latest experiment, “Here,” ponders in an hour and 40 minutes that span multiple centuries and lifetimes unfolding o… [+9541 chars]
Tom Hanks And Robin Wright’s ‘Here’ Opens Flat At Weekend Box Office	"Tom Hanks and Robin Wright in ""Here.""  Sony Pictures Entertainment/Miramax  HereTom Hanks and Robin Wrights reunion movie with their Forrest Gumpdirector Robert Zemeckisis opening weak in theaters.  … [+2372 chars]"
Tom Hanks And Robin Wright’s ‘Here’ Gets Digital Streaming Date	"Tom Hanks and Robin Wright in ""Here.""  Sony Pictures Entertainment/Miramax  HereTom Hanks and Robin Wrights reunion movie with their Forrest Gump director Robert Zemeckisis coming soon to digital str… [+3069 chars]"
‘Here’ Reviews: Critics Bash Tom Hanks And Robin Wright Reunion Movie	"Robin Wright and Tom Hanks in ""Here.""  Sony Pictures Entertainment  Herea drama that reunites Tom Hanks, Robin Wright and director Robert Zemeckisis being met with mostly negative reviews from critic… [+2980 chars]"
‘Venom: The Last Dance,’ ‘The Wild Robot,’ and Specialized Hits Thrive	With a huge late November expected led by “Wicked” (Universal), “Gladiator 2” (Paramount), and “Moana 2” (Disney), another weak weekend ($74 million total, down from $96 million last year) isn’t a di… [+8282 chars]
Robert Zemeckis Didn’t Initially Know If ‘Here’ Would Work As A Movie	"(Left to right) Robert Zemeckis and Tom Hanks attend the 2024 AFI Fest World Premiere Screening of ... [+] 'Here' at TCL Chinese Theatre on October 25, 2024 in Hollywood, California.  FilmMagic  ""Whe… [+7042 chars]"
‘Here’: When Is Tom Hanks And Robin Wright's Drama Coming To Streaming?	"Tom Hanks and Robin Wright in ""Here.""  Sony Pictures Entertainment  The visually innovative Tom Hanks and Robin Wright drama Here is new in theaters. When is it coming to streaming?  Director Robert … [+2473 chars]"
‘Here’ Review: ‘Forrest Gump’ Filmmaker Robert Zemeckis Reunites With Tom Hanks & Robin Wright For Complex Family Story Stuck Somewhere In Time – AFI Fest	Robert Zemeckis clearly has a thing for time – past, present, and Back To The Future. With a filmography that also includes films like Polar Express and especially his Oscar winning Best Picture Forr… [+6271 chars]
Where To Watch Here: Showtimes & Streaming Status	Tom Hanks and Robin Wright reunite with their Forrest Gump director Robert Zemeckis and writer Eric Roth, and there are options for where to watch the 2024 movie Here. The ambitious project reuniting… [+2724 chars]
November Might Debut Four $100 Million-Plus Movies, Led by ‘Wicked,’ ‘Gladiator 2,’ and ‘Moana 2’	The projections game for November’s U.S./Canada box office is easier than next Tuesday’s election. But after October results far off earlier predictions, some caution is advisable  This century befor… [+4676 chars]
All the Songs in the Tom Hanks Movie ‘Here’	Here is here.  And Robert Zemeckis latest technologically innovative drama stars his Forrest Gump team of Tom Hanks and Robin Wright, this time embodying a couple living in a house. The angle of the … [+6159 chars]
Tom Hanks and Robin Wright at the AFI Fest Premiere of HERE	Pin  Tom Hanks went tieless to the premiere of Here, but maybe that’s because his co-star Robin Wright stole his.  Pin  Pin  Pin  Pin  Pin  Pin  Pin  He’s fine. More or less unassailable at this poin… [+1678 chars]
Box Office: ‘Venom 3’ Still No. 1, Tom Hanks’s ‘Here’ Bombs	(AP) — Venom: The Last Dance enjoyed another weekend at the top of the box office. The Sony release starring Tom Hardy added $26.1 million in ticket sales, according to studio estimates Sunday.  It w… [+4784 chars]
Venom: The Last Dance Wins The Weekend Again And Crosses A Box Office Milestone As Here Starring Tom Hanks Fails To Garner Much Buzz	Hollywood didn't exactly pull out the big guns for this past weekend. Thanks to Halloween being on a Thursday, there wasn't a big opportunity for a hot new horror movie to take advantage of the holid… [+6735 chars]
[Removed]	[Removed]
Is The Tom Hanks Movie ‘Here’ Streaming on Netflix or HBO Max?	Thirty years after the release ofForrest Gump, stars Tom Hanks and Robin Wright are reuniting with director Robert Zemeckis for a new movie that’s guaranteed to make you cry, calledHere.  Directed by… [+2500 chars]
Technique and story don't quite mesh in the Tom Hanks movie 'Here'	Tom Hanks and Robin Wright in Here.  Sony Pictures  What if you spent eternity in one living room? That's the premise of Here, a new drama starring Tom Hanks and Robin Wright as a married couple whos… [+274 chars]
Tom Hanks and Robin Wright’s New Movie: ‘Here’ Release Date & More	View galleryImage Credit: Sunset Boulevard/Getty Images)  In the list of beloved classic movie couples, youve got so many to pick from Harry Burns and Sally Albright, Danny Zuko and Sandy Olsson, and… [+2365 chars]
Now That The Venom Trilogy Is Over, I'll Never Forgive The Tom Hardy Franchise For Its Gravest Sin	It was an unusual weekend at the box office   for Sony Pictures. The studio had to dig a shallow grave for Tom Hanks and Robert Zemeckis’ Here, an experimental trip through the generations that doesn… [+4040 chars]
‘Venom 3’ leads box office again, A24’s ‘Heretic’ scares up $11 million bebut in sleepy weekend	Venom: The Last Dance is looming over the domestic box office in its third weekend of release. The third and final installment in Sonys comic book trilogy has added $16.2 million from 3,905 North Ame… [+5004 chars]
‘Here’ Goes Nowhere: Tom Hanks, Robin Wright and the AI Gimmick that Fell Flat	Tom Hanks and Robin Wrights reunion in ‘Here’ falls flat. Courtesy of Sony Pictures Entertainment  If you think Tom Hanks cannot make a bad movie, you havent seen Here. This phony, gimmicky and tedio… [+4010 chars]
Venom 3 tops North American box office again, while Tom Hanks film struggles	Venom: The Last Dance enjoyed another weekend at the top of the North American box office. The Sony release starring Tom Hardy added US$26.1 million (S$34.5 million) in ticket sales, according to stu… [+2240 chars]
‘Venom 3’ tops box office again, while Tom Hanks film struggles	Venom: The Last Dance enjoyed another weekend at the top of the box office. The Sony release starring Tom Hardy added $26.1 million in ticket sales, according to studio estimates Sunday.  It was a re… [+4338 chars]
Venom: The Last Dance Puts Up Unexpected Box Office Numbers In Its Opening Weekend	While Sony's Spider-Man Universe has released a couple of box office bombs in S.J. Clarkson's Madame Web and Daniel Espinosa's Morbius, it's been the Venom movies that have kept the franchise on its … [+7135 chars]
‘Venom 3’ tops box office again, while Tom Hanks film struggles	Venom: The Last Dance enjoyed another weekend at the top of the box office. The Sony release starring Tom Hardy added $26.1 million in ticket sales, according to studio estimates Sunday.  It was a re… [+3768 chars]
Wordware Raises AI Agents And $30 Million, Plus Coca-Cola, Santa, And AI	WASHINGTON, DC - OCTOBER 30: Google and Alphabet CEO Sundar Pichai departs federal court on October ... [+] 30, 2023 in Washington, DC. Pichai testified on Monday to defend his company in the largest… [+8474 chars]
Third ‘Venom’ film tops box office, Tom Hanks flick debuts third	You can’t keep a good symbiote down.  “Venom: The Last Dance” earned another $6.6 million in ticket sales during its second week in theaters, and holds steady at No. 1, according to The Numbers.  The… [+1467 chars]
‘Venom: The Last Dance’ tops box office for second weekend in a row	Venom: The Last Dance enjoyed another weekend at the top of the box office. The Sony release starring Tom Hardy added $26.1 million in ticket sales, according to studio estimates Sunday.  It was a re… [+5137 chars]
Movie Review: An unmoving camera and de-aging technology make 'Here' with Tom Hanks painful to watch	Robert Zemeckis' latest movie is insanely ambitious, starting with the dinosaurs and ending in present day with the Roomba. But it's fixed on just one spot.  Here reunites Zemeckis, screenwriter Eric… [+4551 chars]
Tom Hanks, Robin Wright didn’t 'hang out’ while filming ‘Forrest Gump’ for a very Forrest Gump reason	Its been 30 years since Tom Hanks and Robin Wright starred in the Academy Award-winning classic Forrest Gump, but theyve only recently gotten to spend time together on set.   The pair and the 1994 fi… [+2187 chars]
‘Venom 3’ tops box office again, while Tom Hanks film struggles	Venom: The Last Dance enjoyed another weekend at the top of the box office. The Sony release starring Tom Hardy added $26.1 million in ticket sales, according to studio estimates Sunday.  It was a re… [+2147 chars]
‘Venom 3’ tops box office again, while Tom Hanks film struggles	Venom: The Last Dance enjoyed another weekend at the top of the box office. The Sony release starring Tom Hardy added $26.1 million in ticket sales, according to studio estimates Sunday.  It was a re… [+3754 chars]
When Will ‘Here’ Starring Tom Hanks and Robin Wright Stream on Netflix?	Here – Picture: TriStar Pictures / Sony Pictures Releasing  It’s a reunion for the ages that’s flying under the radar right now. 30 years after Forrest Gump swept the Oscars and became recognized as … [+2172 chars]
[Removed]	[Removed]
[Removed]	[Removed]
[Removed]	[Removed]
Robert Zemeckis is still lost in the uncanny valley. Can he be saved?	Sony  It was only a matter of time before Robert Zemeckis got around to playing with de-aging technology, that modern cinematic magic trick of making veteran movie stars look kind of, sort of like th… [+7614 chars]
‘Venom 3’ tops box office again, while Tom Hanks film struggles	"This image released by Sony Pictures shows a scene from ""Venom: The Last Dance."" (Columbia-Sony Pictures via AP)Courtesy of Sony Pictures/AP  This image released by Sony Pictures shows Tom Hardy in a… [+6616 chars]"
Tom Hanks on Reuniting Onscreen with His 'Forrest Gump' Costar Robin Wright	"Tom Hanks says it was ""so easy"" reconnecting with Robin Wright on the set of their new film Here.   Speaking on the red carpet of the movie's world premiereat AFI Fest in Los Angeles on Friday, Oct. … [+3135 chars]"
Venom Won The Weekend, But More Impressive Internationally	Posted in: Box Office, Movies | Tagged: smile 2, venom: the last dance, Weekend Box Office  Venom: The Last Dance won the weekend but opened soft in the US. This was not the case internationally, how… [+2501 chars]
‘Conclave’, ‘A Complete Unknown’ Lead AARP’s Movies For Grownups Awards Nominations	Edward Berger’s papal thriller Conclaveand the upcoming Timothée Chalamet-starring Bob Dylan biopic A Complete Unknown lead the nominations for the AARP Movies for Grownups Awards, which annually cha… [+3966 chars]
‘Venom 3’ tops box office again, while Tom Hanks film struggles	Venom: The Last Dance enjoyed another weekend at the top of the box office. The Sony release starring Tom Hardy added $26.1 million in ticket sales, according to studio estimates Sunday.  It was a re… [+4947 chars]
‘Venom 3’ tops box office again, while Tom Hanks film struggles	Venom: The Last Dance enjoyed another weekend at the top of the box office. The Sony release starring Tom Hardy added $26.1 million in ticket sales, according to studio estimates Sunday.  It was a re… [+4940 chars]
HERE Review: Tom Hanks, Robert Zemeckis Reunion Disappoints, Underwhelms	As a commercially oriented, artistically ambitious, innovation-embracing filmmaker, Robert Zemeckis (Death Becomes Her, the Back to the Future trilogy, Romancing the Stone) enjoyed an unparalleled pr… [+5655 chars]
